Afrikaans : af_ZA
Albanian: sq_AL
Amharic : am_ET
Arabic: ar_SA
Armenian: hy_AM
Azerbaijani : az_AZ
Basque: eu_ES
Belarusian: be_BY
Bengali : bn_BD
Bosnian : bs_BA
Bulgarian : bg_BG
Catalan : ca_ES
Cebuano : ceb_PH
Chichewa: ny_MW
Chinese (Simplified): zh-Hans_CN
Chinese (Traditional) : zh-Hant_TW
Corsican: co_FR
Haitian Creole: ht_HT
Croatian: hr_HR
Czech : cs_CZ
Danish: da_DK
Dutch : nl_NL
English : en_GB
Esperanto : eo_WORLD
Estonian: et_EE
Finnish : fi_FI
French: fr_CA
Frisian : fy_NL
Galician: gl_ES
Georgian: ka_GE
German: de_DE
Greek : el_GR
Gujarati: gu_IN
Hausa : ha_NE
Hawaiian: haw_US
Hebrew: he_IL
Hindi : hi_IN
Hmong : hmn_CN
Hungarian : hu_HU
Icelandic : is_IS
Igbo: ig_NG
Indonesian: id_ID
Irish : ga_IE
Italian : it_IT
Japanese: ja_JP
Javanese: jv_ID
Kannada : kn_IN
Kazakh: kk_KZ
Khmer : km_KH
Kinyarwanda : rw_RW
Korean: ko_KR
Kurdish (Kurmanji): ku_IR
Kyrgyz: ky_KG
Lao : lo_LA
Latin : la_VAT
Latvian : lv_LV
Lithuanian: lt_LT
Luxembourgish : lb_LU
Macedonian: mk_MK
Malagasy: mg_MG
Malay : ms_MY
Malayalam : ml_IN
Maltese : mt_MT
Maori : mi_NZ
Marathi : mr_IN
Mongolian : mn_MN
Myanmar (Burmese) : my_MM
Nepali: ne_NP
Norwegian : no_NO
Odia: or_OR
Pashto: ps_AF
Persian : fa_IR
Polish: pl_PL
Portuguese: pt_PT
Punjabi : pa_PK
Romanian: ro_RO
Russian : ru_RU
Samoan: sm_WS
Scots Gaelic: gd_GB
Serbian Cyrilic : sr-Cyrl_RS
Sesotho : st_LS
Shona : sn_ZW
Sindhi: sd_PK
Sinhala : si_LK
Slovak: sk_SK
Slovenian : sl_SI
Somali: so_SO
Spanish : es_ES
Sundanese : su_ID
Swahili : sw_TZ
Swedish : sv_SE
Filipino (Tagalog): tl_PH
Tajik : tg_TJ
Tamil : ta_IN
Tatar : tt_TT
Telugu: te_IN
Thai: th_TH
Turkish : tr_TR
Turkmen : tk_TK
Ukrainian : uk_UA
Urdu: ur_PK
Uyghur: ug_UG
Uzbek : uz_UZ
Vietnamese: vi_VN
Welsh : cy_GB
Xhosa : xh_ZA
Yiddish : yi_IL
Yoruba: yo_NG
Zulu: zu_ZA